"customer_ID";"Wine(USD)";"Fruits(USD)";"Meat_prods(USD)";"Fish_prods(USD)";"Sweet_prods(USD)";"Gold_prods(USD)";"MntTotal";"true_total_spend"
1;9;0;6;3;1;3;19;22
2;482;34;471;119;68;22;1174;1196
3;220;0;33;3;0;23;256;279
4;350;60;568;110;133;145;1221;1366
5;6;16;11;11;1;16;45;61
6;688;14;309;201;24;38;1236;1274
7;824;32;162;42;32;43;1092;1135
8;54;0;7;0;0;4;61;65
9;247;49;159;7;82;109;544;653
10;587;43;337;42;87;54;1096;1150
11;3;1;10;3;2;12;19;31
12;386;172;183;185;132;111;1058;1169
13;40;0;19;2;1;3;62;65
14;796;14;590;38;44;0;1482;1482
15;856;59;487;58;29;73;1489;1562
16;194;61;480;225;112;30;1072;1102
17;135;9;39;4;0;7;187;194
18;702;17;151;0;8;35;878;913
19;123;164;266;227;30;174;810;984
20;1170;48;320;42;32;192;1612;1804
21;496;36;460;189;60;12;1241;1253
22;0;1;3;10;6;9;20;29
23;6;3;14;15;7;36;45;81
24;15;2;10;0;1;4;28;32
25;258;107;291;84;37;86;777;863
26;12;5;25;0;9;30;51;81
27;565;6;65;0;6;19;642;661
28;233;2;53;3;5;14;296;310
29;70;0;16;0;0;4;86;90
30;1;6;7;11;5;3;30;33
31;72;24;68;65;4;8;233;241
32;614;16;132;43;33;33;838;871
33;14;10;13;4;15;9;56;65
34;53;1;34;2;0;16;90;106
35;1;1;1725;1;1;1;1729;1730
36;163;23;424;27;65;76;702;778
37;320;48;133;39;72;48;612;660
38;562;81;276;80;40;81;1039;1120
39;27;2;14;0;0;0;43;43
40;635;88;546;172;88;88;1529;1617
41;295;35;482;121;120;40;1053;1093
42;2;1;6;2;1;1;12;13
43;613;22;319;33;102;12;1089;1101
44;10;0;10;3;1;7;24;31
45;763;29;138;76;176;58;1182;1240
46;15;0;8;4;2;20;29;49
47;32;34;41;73;16;116;196;312
48;867;0;86;0;0;19;953;972
49;721;111;925;97;18;18;1872;1890
50;5;3;11;12;5;9;36;45
51;11;1;6;2;1;6;21;27
52;384;0;102;21;32;5;539;544
53;656;16;106;32;16;8;826;834
54;224;0;30;0;0;10;254;264
55;270;3;27;39;6;99;345;444
56;217;76;690;50;26;38;1059;1097
57;492;19;110;16;12;12;649;661
58;55;0;6;2;0;4;63;67
59;34;3;29;0;4;10;70;80
60;13;0;8;2;1;5;24;29
61;17;1;12;3;1;4;34;38
62;6;4;25;15;12;13;62;75
63;1032;105;779;137;105;51;2158;2209
64;505;0;26;0;0;75;531;606
65;447;0;28;0;0;43;475;518
66;519;17;813;27;173;51;1549;1600
67;17;8;14;10;4;3;53;56
68;410;0;59;19;9;44;497;541
69;30;11;25;29;1;18;96;114
70;173;4;30;3;6;41;216;257
71;962;61;921;52;61;20;2057;2077
72;9;0;7;3;4;7;23;30
73;712;26;538;69;13;80;1358;1438
74;51;2;7;0;1;2;61;63
75;1;0;5;0;3;9;9;18
76;239;10;554;254;87;54;1144;1198
77;344;189;482;50;33;172;1098;1270
78;207;26;447;75;0;223;755;978
79;17;0;14;7;3;2;41;43
80;598;16;141;32;41;49;828;877
81;171;7;171;25;19;89;393;482
82;22;0;13;0;0;3;35;38
83;577;0;64;0;0;51;641;692
84;96;1;79;7;1;79;184;263
85;12;0;4;0;0;1;16;17
86;1;3;6;10;0;9;20;29
87;722;27;102;44;72;168;967;1135
88;377;10;540;80;30;10;1037;1047
89;135;46;92;65;61;11;399;410
90;64;4;68;7;5;17;148;165
91;1076;16;417;42;48;16;1599;1615
92;448;4;34;6;4;39;496;535
93;120;58;73;65;89;58;405;463
94;738;0;232;13;20;50;1003;1053
95;534;5;47;0;5;41;591;632
96;162;33;124;40;28;172;387;559
97;53;1;5;2;1;10;62;72
98;2;1;18;20;11;16;52;68
99;4;1;5;2;0;4;12;16
100;6;4;1;7;2;15;20;35
101;182;4;33;0;0;66;219;285
102;265;138;553;224;23;92;1203;1295
103;399;28;756;36;40;126;1259;1385
104;144;1;32;2;1;7;180;187
105;130;0;16;0;0;5;146;151
106;450;133;951;173;0;216;1707;1923
107;41;1;6;2;0;5;50;55
108;7;6;13;7;6;14;39;53
109;520;7;154;19;0;14;700;714
110;25;5;19;7;0;23;56;79
111;236;106;189;23;41;130;595;725
112;295;106;271;75;98;65;845;910
113;18;1;32;6;3;28;60;88
114;983;76;184;180;138;27;1561;1588
115;292;6;37;0;3;34;338;372
116;778;44;499;95;73;146;1489;1635
117;6;1;10;0;1;4;18;22
118;212;6;69;4;12;3;303;306
119;125;16;98;134;21;27;394;421
120;64;1;21;0;1;27;87;114
121;382;114;276;75;124;38;971;1009
122;16;7;23;0;8;6;54;60
123;212;5;33;7;0;2;257;259
124;14;1;7;2;1;1;25;26
125;81;18;113;47;13;21;272;293
126;167;0;43;6;2;13;218;231
127;155;1;25;0;1;3;182;185
128;12;11;10;3;12;9;48;57
129;277;162;305;173;76;124;993;1117
130;801;0;80;0;0;35;881;916
131;559;153;503;218;13;181;1446;1627
132;620;26;195;34;17;141;892;1033
133;73;3;90;12;1;32;179;211
134;13;2;14;8;7;4;44;48
135;76;3;31;4;4;27;118;145
136;36;0;12;2;2;10;52;62
137;15;10;19;8;17;20;69;89
138;47;1;6;0;0;12;54;66
139;789;0;133;0;28;152;950;1102
140;513;14;154;19;0;28;700;728
141;897;23;207;15;11;92;1153;1245
142;33;6;40;3;7;10;89;99
143;42;16;29;12;20;8;119;127
144;1;9;7;2;14;10;33;43
145;7;3;10;8;1;7;29;36
146;37;0;46;4;3;0;90;90
147;11;0;5;0;0;1;16;17
148;36;2;42;20;21;10;121;131
149;426;49;127;111;21;42;734;776
150;80;15;93;20;13;52;221;273
151;625;7;99;10;22;7;763;770
152;10;1;18;10;4;7;43;50
153;12;4;6;11;8;16;41;57
154;14;1;21;2;3;25;41;66
155;216;162;224;101;92;162;795;957
156;525;147;112;219;147;63;1150;1213
157;85;7;24;2;3;27;121;148
158;35;0;2;0;0;2;37;39
159;68;129;396;188;22;15;803;818
160;452;18;102;16;18;6;606;612
161;437;8;206;160;49;42;860;902
162;684;100;801;21;66;0;1672;1672
163;1;26;25;17;23;15;92;107
164;11;4;20;10;3;5;48;53
165;81;0;6;0;0;6;87;93
166;131;0;16;2;1;39;150;189
167;421;76;536;82;178;102;1293;1395
168;295;21;78;39;13;13;446;459
169;523;7;134;37;14;169;715;884
170;173;43;118;46;27;15;407;422
171;546;0;48;0;6;6;600;606
172;356;0;107;19;9;117;491;608
173;196;0;512;33;130;54;871;925
174;3;1;8;4;3;3;19;22
175;454;194;106;31;22;43;807;850
176;675;11;400;15;45;11;1146;1157
177;1218;16;272;104;0;80;1610;1690
178;8;1;7;2;0;0;18;18
179;297;7;79;0;11;182;394;576
180;783;30;537;140;76;15;1566;1581
181;635;15;100;20;7;131;777;908
182;520;42;98;0;42;14;702;716
183;547;99;812;151;82;33;1691;1724
184;8;4;10;2;2;4;26;30
185;346;17;48;23;13;13;447;460
186;509;0;27;0;0;10;536;546
187;925;64;179;133;12;77;1313;1390
188;235;65;164;50;49;27;563;590
189;112;17;44;34;22;89;229;318
190;13;1;29;3;0;7;46;53
191;398;40;367;119;122;30;1046;1076
192;76;10;56;3;1;23;146;169
193;110;0;5;2;0;3;117;120
194;0;4;5;6;0;4;15;19
195;42;1;18;3;0;4;64;68
196;14;0;24;3;3;2;44;46
197;42;11;57;10;28;14;148;162
198;4;19;9;28;25;17;85;102
199;1;3;6;3;6;15;19;34
200;425;115;292;23;35;79;890;969
201;96;12;96;33;22;43;259;302
202;47;90;94;123;103;120;457;577
203;28;0;6;1;1;13;36;49
204;787;20;204;0;0;92;1011;1103
205;10;0;1;0;0;0;11;11
206;562;21;464;28;10;32;1085;1117
207;154;2;46;20;4;15;226;241
208;864;134;768;150;38;172;1954;2126
209;233;20;57;8;20;91;338;429
210;536;11;387;149;91;57;1174;1231
211;248;3;81;4;3;51;339;390
212;1332;17;311;23;51;86;1734;1820
213;412;5;119;38;29;77;603;680
214;5;0;3;0;0;5;8;13
215;20;6;5;0;9;12;40;52
216;1;4;10;29;0;36;44;80
217;204;34;204;172;153;173;767;940
218;792;86;740;67;51;17;1736;1753
219;39;0;56;20;8;14;123;137
220;3;5;14;2;12;17;36;53
221;5;9;20;6;8;21;48;69
222;3;3;7;6;2;9;21;30
223;59;0;12;0;0;48;71;119
224;5;7;24;19;14;20;69;89
225;30;0;9;0;0;3;39;42
226;1349;16;249;43;16;33;1673;1706
227;16;0;3;0;0;1;19;20
228;189;104;379;111;189;218;972;1190
229;527;0;21;0;0;60;548;608
230;204;7;149;20;15;66;395;461
231;777;129;573;216;21;203;1716;1919
232;18;0;4;0;0;1;22;23
233;466;22;432;147;113;102;1180;1282
234;15;0;12;7;3;7;37;44
235;1149;71;449;69;71;26;1809;1835
236;53;3;49;7;4;5;116;121
237;9;0;3;0;0;4;12;16
238;4;1;9;3;0;0;17;17
239;8;3;22;21;1;13;55;68
240;495;33;255;11;33;8;827;835
241;415;5;124;15;35;11;594;605
242;9;1;3;0;4;8;17;25
243;888;0;57;0;0;76;945;1021
244;731;60;353;78;12;73;1234;1307
245;847;66;119;86;89;111;1207;1318
246;656;80;455;52;107;93;1350;1443
247;1241;0;80;0;13;40;1334;1374
248;29;0;14;0;0;2;43;45
249;424;17;118;7;23;41;589;630
250;960;28;183;220;70;70;1461;1531
251;452;20;514;13;30;0;1029;1029
252;25;0;8;2;0;2;35;37
253;792;0;275;45;45;126;1157;1283
254;26;0;8;0;0;3;34;37
255;23;3;21;3;19;22;69;91
256;6;4;7;4;3;8;24;32
257;546;91;410;119;0;22;1166;1188
258;16;3;25;6;1;13;51;64
259;768;44;561;77;44;14;1494;1508
260;2;0;5;2;0;1;9;10
261;152;3;22;2;5;7;184;191
262;65;4;16;0;4;11;89;100
263;21;2;28;3;2;9;56;65
264;235;6;45;8;9;12;303;315
265;15;6;20;4;5;20;50;70
266;395;15;263;60;54;38;787;825
267;168;148;444;32;172;148;964;1112
268;22;1;11;0;1;2;35;37
269;1048;0;217;0;0;12;1265;1277
270;304;98;230;150;74;74;856;930
271;185;0;28;3;2;17;218;235
272;45;47;52;21;20;25;185;210
273;1;2;8;4;3;13;18;31
274;33;0;5;0;0;0;38;38
275;19;3;10;11;8;6;51;57
276;5;3;10;12;7;20;37;57
277;22;2;14;0;1;10;39;49
278;317;46;247;151;46;139;807;946
279;650;28;353;45;42;30;1118;1148
280;490;44;125;29;20;22;708;730
281;247;8;160;6;8;65;429;494
282;182;74;298;162;149;116;865;981
283;68;7;59;10;5;11;149;160
284;231;7;137;4;15;39;394;433
285;797;153;293;72;97;30;1412;1442
286;1001;12;240;16;12;12;1281;1293
287;901;61;757;186;163;20;2068;2088
288;997;26;269;34;13;42;1339;1381
289;10;7;19;8;2;21;46;67
290;3;3;7;0;2;11;15;26
291;24;0;7;0;0;1;31;32
292;378;0;101;0;0;72;479;551
293;78;0;11;0;0;10;89;99
294;554;41;215;11;0;24;821;845
295;10;4;7;0;6;3;27;30
296;24;0;8;0;0;1;32;33
297;404;0;92;28;27;142;551;693
298;11;0;4;0;0;2;15;17
299;483;84;398;205;84;241;1254;1495
300;9;1;6;3;0;4;19;23
301;512;0;83;0;0;41;595;636
302;10;2;16;11;2;21;41;62
303;1103;0;45;0;0;34;1148;1182
304;11;2;9;3;0;8;25;33
305;167;2;62;24;13;7;268;275
306;159;4;45;6;2;38;216;254
307;561;64;785;84;128;48;1622;1670
308;77;2;35;0;1;69;115;184
309;378;14;68;19;14;14;493;507
310;918;21;118;13;10;21;1080;1101
311;44;4;21;6;0;27;75;102
312;7;1;6;3;1;11;18;29
313;40;2;15;8;0;6;65;71
314;285;28;242;55;114;135;724;859
315;382;138;65;60;26;59;671;730
316;1;6;7;0;1;3;15;18
317;629;17;177;69;0;8;892;900
318;357;35;271;28;28;14;719;733
319;333;0;815;129;42;29;1319;1348
320;977;12;253;16;12;101;1270;1371
321;866;21;151;28;21;86;1087;1173
322;138;33;87;28;24;12;310;322
323;856;61;570;40;25;122;1552;1674
324;38;4;22;3;3;3;70;73
325;91;64;128;65;3;50;351;401
326;127;1;56;0;1;31;185;216
327;395;183;565;166;141;28;1450;1478
328;604;0;100;19;0;28;723;751
329;909;11;218;0;0;23;1138;1161
330;400;4;35;6;0;22;445;467
331;2;3;20;6;11;9;42;51
332;57;0;27;0;0;36;84;120
333;325;83;300;86;58;91;852;943
334;269;15;69;15;19;38;387;425
335;9;0;6;4;1;5;20;25
336;99;0;15;2;1;5;117;122
337;11;0;7;3;1;6;22;28
338;19;3;19;3;1;3;45;48
339;238;17;68;8;10;6;341;347
340;12;4;2;10;6;10;34;44
341;3;9;15;13;2;39;42;81
342;833;33;549;151;133;233;1699;1932
343;1;11;5;4;6;9;27;36
344;504;13;131;8;0;26;656;682
345;16;36;21;20;62;108;155;263
346;162;61;83;97;57;61;460;521
347;1168;92;408;72;129;55;1869;1924
348;12;0;1;0;0;6;13;19
349;2;2;2;2;1;1;9;10
350;619;54;260;127;54;54;1114;1168
351;5;4;13;8;0;4;30;34
352;1248;16;349;43;16;16;1672;1688
353;10;4;14;4;4;1;36;37
354;456;4;24;0;0;9;484;493
355;284;0;55;0;6;52;345;397
356;4;7;7;6;4;13;28;41
357;317;25;265;25;19;12;651;663
358;112;6;92;3;9;38;222;260
359;77;28;31;16;0;4;152;156
360;1047;0;140;67;38;153;1292;1445
361;1076;68;103;29;91;68;1367;1435
362;11;3;22;2;2;6;40;46
363;177;2;71;3;2;20;255;275
364;1288;20;613;80;61;27;2062;2089
365;235;0;235;19;4;191;493;684
366;1043;24;97;32;24;157;1220;1377
367;456;19;832;75;118;38;1500;1538
368;172;12;112;8;0;15;304;319
369;815;10;239;28;10;108;1102;1210
370;789;0;142;12;9;38;952;990
371;3;1;2;4;3;1;13;14
372;78;0;11;0;0;7;89;96
373;29;1;9;2;0;2;41;43
374;736;163;818;212;163;61;2092;2153
375;515;47;181;149;95;95;987;1082
376;554;35;113;0;7;78;709;787
377;65;0;46;4;3;20;118;138
378;38;4;22;4;2;20;70;90
379;314;11;53;4;3;107;385;492
380;1285;42;716;55;0;21;2098;2119
381;23;1;13;2;2;18;41;59
382;919;0;505;99;30;45;1553;1598
383;225;162;387;106;36;29;916;945
384;11;7;9;3;1;11;31;42
385;96;1;42;12;3;32;154;186
386;227;23;389;42;21;75;702;777
387;438;66;400;12;38;114;954;1068
388;5;2;16;3;2;19;28;47
389;3;9;13;2;12;12;39;51
390;571;50;142;33;50;159;846;1005
391;1035;134;670;25;38;0;1902;1902
392;2;0;6;8;6;5;22;27
393;493;70;324;146;40;84;1073;1157
394;1396;0;322;46;35;17;1799;1816
395;594;134;786;33;134;57;1681;1738
396;37;32;38;11;3;18;121;139
397;966;26;282;52;26;26;1352;1378
398;145;13;46;17;2;4;223;227
399;822;114;108;179;137;114;1360;1474
400;557;129;761;29;185;111;1661;1772
401;203;0;10;0;0;2;213;215
402;7;4;13;15;8;17;47;64
403;9;0;16;6;6;10;37;47
404;10;0;7;2;0;1;19;20
405;1492;38;287;50;57;33;1924;1957
406;27;1;12;2;0;10;42;52
407;6;0;2;2;0;1;10;11
408;37;12;23;8;11;52;91;143
409;14;0;3;0;0;4;17;21
410;11;0;5;0;0;1;16;17
411;46;0;7;0;0;2;53;55
412;140;4;61;0;13;4;218;222
413;30;8;12;8;8;12;66;78
414;31;1;13;7;2;9;54;63
415;529;0;356;63;28;0;976;976
416;12;0;4;0;0;1;16;17
417;982;73;351;56;14;175;1476;1651
418;249;153;940;58;134;38;1534;1572
419;98;0;106;49;10;106;263;369
420;551;137;792;179;103;33;1762;1795
421;1060;21;530;32;0;224;1643;1867
422;179;2;64;38;17;58;300;358
423;465;25;132;136;0;37;758;795
424;264;47;188;54;47;11;600;611
425;32;0;5;0;0;1;37;38
426;3;6;5;0;2;6;16;22
427;51;12;49;17;24;24;153;177
428;1379;33;216;0;33;66;1661;1727
429;129;129;259;168;121;83;806;889
430;399;4;30;6;4;30;443;473
431;174;18;81;28;6;24;307;331
432;388;14;218;91;14;21;725;746
433;8;9;9;2;5;22;33;55
434;375;152;335;93;91;81;1046;1127
435;19;0;35;6;4;17;64;81
436;817;183;797;106;163;20;2066;2086
437;292;127;635;132;127;165;1313;1478
438;800;0;297;0;34;57;1131;1188
439;32;1;64;16;12;85;125;210
440;12;6;2;11;2;16;33;49
441;130;30;168;20;34;0;382;382
442;6;4;16;3;10;30;39;69
443;43;12;96;78;40;55;269;324
444;16;12;18;7;1;13;54;67
445;102;9;63;2;9;24;185;209
446;3;18;14;15;22;50;72;122
447;19;0;9;0;0;2;28;30
448;8;4;15;7;6;2;40;42
449;4;7;15;13;9;15;48;63
450;881;38;319;16;25;12;1279;1291
451;31;3;31;2;8;4;75;79
452;13;2;21;4;0;24;40;64
453;3;14;17;6;1;5;41;46
454;141;15;153;67;31;35;407;442
455;464;151;292;65;60;30;1032;1062
456;36;0;2;0;0;4;38;42
457;13;6;15;3;5;13;42;55
458;526;28;135;10;21;99;720;819
459;400;32;519;71;75;54;1097;1151
460;410;16;114;0;5;49;545;594
461;389;91;248;64;49;41;841;882
462;2;2;11;10;6;12;31;43
463;189;2;29;3;2;40;225;265
464;28;0;4;0;0;0;32;32
465;1000;19;711;125;115;38;1970;2008
466;80;3;26;4;2;14;115;129
467;1000;155;379;224;17;120;1775;1895
468;16;0;17;6;3;6;42;48
469;378;0;189;97;172;172;836;1008
470;206;10;67;30;27;71;340;411
471;245;19;125;37;67;14;493;507
472;162;25;53;16;0;10;256;266
473;10;6;11;0;4;2;31;33
474;721;0;152;119;50;50;1042;1092
475;390;22;323;104;35;107;874;981
476;315;4;62;41;31;146;453;599
477;84;5;38;150;12;28;289;317
478;10;2;15;2;1;6;30;36
479;2;8;1;4;7;15;22;37
480;650;37;780;27;167;32;1661;1693
481;215;63;507;231;31;190;1047;1237
482;1001;17;572;93;125;17;1808;1825
483;747;10;161;65;40;42;1023;1065
484;19;18;33;24;1;8;95;103
485;757;80;217;29;80;11;1163;1174
486;12;6;20;30;1;3;69;72
487;41;5;129;10;3;3;188;191
488;434;22;388;104;22;34;970;1004
489;88;10;46;2;3;64;149;213
490;1012;80;498;0;16;176;1606;1782
491;215;13;87;17;17;24;349;373
492;410;112;420;0;82;71;1024;1095
493;321;11;309;33;26;34;700;734
494;5;1;13;3;5;1;27;28
495;30;2;25;0;1;9;58;67
496;100;1;39;6;1;76;147;223
497;212;123;177;15;64;23;591;614
498;8;4;5;15;2;11;34;45
499;1181;107;199;39;30;30;1556;1586
500;27;0;5;0;0;3;32;35
501;909;12;278;0;12;242;1211;1453
502;510;120;550;156;40;241;1376;1617
503;410;0;592;147;22;22;1171;1193
504;509;0;65;7;11;5;592;597
505;219;3;100;26;0;17;348;365
506;1184;32;352;21;16;16;1605;1621
507;4;17;19;30;24;39;94;133
508;163;2;40;8;11;11;224;235
509;603;45;207;36;18;54;909;963
510;111;3;28;2;6;15;150;165
511;7;0;12;13;7;32;39;71
512;445;53;213;104;98;151;913;1064
513;1006;22;115;59;68;45;1270;1315
514;112;19;21;16;14;5;182;187
515;1009;181;104;202;21;207;1517;1724
516;5;6;10;6;5;10;32;42
517;2;2;11;41;7;11;63;74
518;826;50;317;50;38;38;1281;1319
519;445;25;706;80;76;48;1332;1380
520;328;9;124;12;24;109;497;606
521;179;8;83;19;11;26;300;326
522;10;24;15;13;1;30;63;93
523;352;0;27;10;0;15;389;404
524;294;142;218;164;58;151;876;1027
525;86;2;73;69;38;48;268;316
526;101;13;76;20;18;40;228;268
527;17;8;12;11;15;32;63;95
528;4;1;11;6;2;2;24;26
529;292;3;77;10;3;26;385;411
530;514;22;732;42;198;79;1508;1587
531;412;22;132;59;28;183;653;836
532;6;1;7;23;4;19;41;60
533;8;0;3;0;0;0;11;11
534;53;5;19;2;13;4;92;96
535;125;6;73;8;4;19;216;235
536;984;51;432;180;120;190;1767;1957
537;625;35;169;58;17;35;904;939
538;14;0;3;0;0;3;17;20
539;349;4;78;6;0;43;437;480
540;23;0;8;6;2;18;39;57
541;39;1;9;2;1;34;52;86
542;965;69;279;54;41;69;1408;1477
543;14;0;1;0;0;1;15;16
544;6;10;21;19;14;42;70;112
545;144;2;99;7;2;30;254;284
546;522;0;257;32;16;66;827;893
547;509;133;497;78;24;97;1241;1338
548;161;0;253;199;191;122;804;926
549;387;20;713;38;54;163;1212;1375
550;327;9;122;19;14;83;491;574
551;537;6;42;16;6;30;607;637
552;299;5;201;21;21;49;547;596
553;1039;43;204;153;58;29;1497;1526
554;371;159;194;58;106;141;888;1029
555;948;10;86;13;21;21;1078;1099
556;112;0;6;2;1;14;121;135
557;99;13;66;43;8;4;229;233
558;7;5;39;17;15;37;83;120
559;707;21;250;85;43;73;1106;1179
560;39;2;25;4;3;24;73;97
561;411;0;26;0;0;21;437;458
562;275;59;107;69;101;59;611;670
563;749;40;294;121;160;147;1364;1511
564;34;1;19;2;7;0;63;63
565;28;1;21;3;0;10;53;63
566;116;11;72;3;17;46;219;265
567;789;25;420;16;38;0;1288;1288
568;1126;28;211;37;28;42;1430;1472
569;586;66;653;17;0;26;1322;1348
570;345;25;501;63;138;80;1072;1152
571;203;35;305;46;17;227;606;833
572;1;10;11;19;3;15;44;59
573;1;1;5;0;3;1;10;11
574;245;16;223;21;43;16;548;564
575;13;11;24;13;8;40;69;109
576;161;28;136;32;3;45;360;405
577;0;6;3;7;6;12;22;34
578;967;0;617;43;50;0;1677;1677
579;1004;12;145;32;12;36;1205;1241
580;9;4;18;7;5;5;43;48
581;26;0;6;0;0;2;32;34
582;187;81;149;25;43;91;485;576
583;307;26;360;138;31;40;862;902
584;19;1;10;2;1;8;33;41
585;1239;17;413;23;34;17;1726;1743
586;712;0;45;0;0;191;757;948
587;138;3;38;4;0;59;183;242
588;0;0;1;2;12;5;15;20
589;1063;89;102;16;12;25;1282;1307
590;143;15;60;24;23;5;265;270
591;432;79;341;177;136;170;1165;1335
592;440;81;368;0;122;174;1011;1185
593;56;4;76;17;1;18;154;172
594;111;16;37;7;9;18;180;198
595;28;23;29;29;14;47;123;170
596;4;1;5;2;0;3;12;15
597;623;53;178;23;17;133;894;1027
598;1;3;4;2;2;6;12;18
599;901;31;345;75;31;191;1383;1574
600;121;103;69;8;44;48;345;393
601;305;3;27;4;3;144;342;486
602;398;96;447;220;96;32;1257;1289
603;76;14;74;13;5;10;182;192
604;138;39;63;55;18;21;313;334
605;365;32;117;34;110;6;658;664
606;606;148;228;15;148;22;1145;1167
607;664;58;83;32;0;66;837;903
608;604;26;470;123;161;94;1384;1478
609;647;107;391;175;67;40;1387;1427
610;8;2;5;3;0;3;18;21
611;418;61;428;80;51;10;1038;1048
612;335;42;127;28;5;5;537;542
613;2;5;12;4;8;7;31;38
614;595;23;123;10;23;154;774;928
615;1132;134;384;175;134;115;1959;2074
616;0;0;1;7;4;6;12;18
617;398;190;537;61;156;37;1342;1379
618;670;9;249;0;28;9;956;965
619;656;38;161;62;47;37;964;1001
620;372;18;126;47;48;78;611;689
621;563;76;384;84;192;89;1299;1388
622;6;4;9;6;36;35;61;96
623;709;93;374;104;80;80;1360;1440
624;595;97;291;127;133;121;1243;1364
625;25;0;22;2;3;5;52;57
626;899;102;838;133;102;40;2074;2114
627;1200;105;758;0;42;147;2105;2252
628;23;1;25;0;8;7;57;64
629;184;174;256;50;30;32;694;726
630;34;4;66;3;10;20;117;137
631;393;0;239;90;69;69;791;860
632;283;17;372;138;106;44;916;960
633;31;0;7;2;0;6;40;46
634;524;0;134;28;28;155;714;869
635;760;40;480;0;40;26;1320;1346
636;610;105;125;137;42;21;1019;1040
637;260;86;559;63;9;67;977;1044
638;14;2;30;8;2;3;56;59
639;14;7;11;11;0;5;43;48
640;410;73;747;76;161;30;1467;1497
641;4;3;7;0;3;11;17;28
642;67;5;61;3;8;19;144;163
643;2;0;8;2;2;3;14;17
644;70;0;11;2;8;23;91;114
645;359;35;314;93;116;89;917;1006
646;6;0;6;2;1;1;15;16
647;459;0;24;6;0;4;489;493
648;65;36;74;38;20;110;233;343
649;208;7;82;30;66;35;393;428
650;141;70;106;72;19;23;408;431
651;416;0;26;0;0;4;442;446
652;466;0;224;119;49;99;858;957
653;99;4;32;37;54;6;226;232
654;799;12;375;16;12;12;1214;1226
655;769;80;252;15;34;65;1150;1215
656;19;3;19;4;5;26;50;76
657;43;12;23;29;15;61;122;183
658;597;166;597;172;166;249;1698;1947
659;376;9;83;19;4;4;491;495
660;507;19;364;25;47;9;962;971
661;67;15;80;17;11;80;190;270
662;3;10;8;3;16;32;40;72
663;164;24;103;12;3;42;306;348
664;639;8;166;11;8;58;832;890
665;2;0;7;3;7;10;19;29
666;895;10;101;13;0;152;1019;1171
667;746;8;125;11;8;8;898;906
668;518;42;742;55;56;84;1413;1497
669;40;2;23;0;4;23;69;92
670;34;11;137;179;61;45;422;467
671;301;7;74;10;0;58;392;450
672;67;1;20;0;2;31;90;121
673;606;24;974;197;194;64;1995;2059
674;350;8;66;17;4;4;445;449
675;92;4;18;3;3;6;120;126
676;1;9;8;11;3;22;32;54
677;116;6;82;6;6;41;216;257
678;76;0;7;0;0;16;83;99
679;63;10;83;7;19;19;182;201
680;7;2;4;2;1;4;16;20
681;587;51;898;247;0;86;1783;1869
682;22;1;13;4;0;4;40;44
683;430;16;322;43;24;33;835;868
684;252;3;42;4;3;102;304;406
685;4;2;11;2;0;4;19;23
686;1478;19;403;0;19;0;1919;1919
687;24;1;16;12;2;5;55;60
688;12;2;17;6;1;10;38;48
689;778;178;689;41;27;44;1713;1757
690;198;18;252;32;108;54;608;662
691;23;0;11;3;2;2;39;41
692;20;1;28;3;3;2;55;57
693;565;32;435;28;32;54;1092;1146
694;330;5;159;36;27;16;557;573
695;8;4;10;6;7;6;35;41
696;19;3;26;10;9;3;67;70
697;68;0;226;51;157;68;502;570
698;4;1;6;4;1;9;16;25
699;31;0;6;0;1;8;38;46
700;416;46;925;60;107;46;1554;1600
701;273;11;178;62;83;29;607;636
702;42;7;43;20;12;10;124;134
703;8;7;9;13;6;12;43;55
704;11;5;22;12;5;11;55;66
705;194;55;134;15;0;3;398;401
706;1170;19;594;99;76;134;1958;2092
707;155;7;80;13;7;10;262;272
708;184;23;446;30;23;23;706;729
709;14;3;21;2;1;28;41;69
710;642;14;49;0;7;57;712;769
711;478;0;193;110;75;117;856;973
712;479;5;82;7;17;171;590;761
713;7;17;18;6;10;26;58;84
714;14;0;24;3;3;2;44;46
715;20;3;4;2;0;2;29;31
716;17;0;3;0;0;1;20;21
717;351;16;156;7;5;145;535;680
718;522;0;522;227;120;134;1391;1525
719;205;20;47;23;2;56;297;353
720;794;115;243;150;0;205;1302;1507
721;79;7;58;6;3;18;153;171
722;421;5;90;0;16;10;532;542
723;185;2;88;15;5;14;295;309
724;48;13;57;24;15;25;157;182
725;18;6;15;12;8;17;59;76
726;183;33;493;59;103;57;871;928
727;502;12;109;16;6;90;645;735
728;18;2;19;0;2;6;41;47
729;171;0;11;0;1;20;183;203
730;412;12;546;78;182;0;1230;1230
731;2;5;7;0;18;18;32;50
732;840;53;804;23;71;17;1791;1808
733;15;4;10;3;4;18;36;54
734;255;31;446;40;56;175;828;1003
735;20;6;43;19;5;38;93;131
736;370;9;92;6;9;4;486;490
737;983;20;389;240;50;40;1682;1722
738;70;0;17;0;0;6;87;93
739;91;65;52;10;44;28;262;290
740;200;5;44;0;10;20;259;279
741;324;48;186;39;18;198;615;813
742;6;5;5;8;0;5;24;29
743;4;22;11;3;7;32;47;79
744;691;0;69;10;0;130;770;900
745;2;14;28;16;3;7;63;70
746;6;16;24;11;0;34;57;91
747;243;101;405;29;40;40;818;858
748;25;6;25;6;0;0;62;62
749;362;50;431;134;35;54;1012;1066
750;4;8;11;12;2;13;37;50
751;407;53;221;58;150;26;889;915
752;30;0;8;2;0;14;40;54
753;458;0;24;6;4;34;492;526
754;724;74;929;97;55;130;1879;2009
755;605;91;399;0;45;205;1140;1345
756;1200;0;204;38;29;14;1471;1485
757;181;21;69;39;3;96;313;409
758;1050;12;144;0;0;24;1206;1230
759;547;7;140;0;7;63;701;764
760;11;0;5;2;1;1;19;20
761;20;2;23;3;1;4;49;53
762;562;58;168;43;16;142;847;989
763;30;3;47;19;21;42;120;162
764;104;1;54;13;9;14;181;195
765;85;44;54;102;78;6;363;369
766;183;2;64;7;2;12;258;270
767;680;11;392;75;0;0;1158;1158
768;8;2;15;0;10;18;35;53
769;0;0;1;8;3;2;12;14
770;117;0;22;13;0;30;152;182
771;151;7;89;0;7;28;254;282
772;583;34;309;0;22;125;948;1073
773;224;2;25;7;0;110;258;368
774;25;1;9;2;1;1;38;39
775;825;8;53;11;0;242;897;1139
776;179;28;520;111;123;47;961;1008
777;9;4;17;10;2;7;42;49
778;336;123;274;46;123;141;902;1043
779;327;9;125;25;4;139;490;629
780;483;0;591;156;0;12;1230;1242
781;191;9;97;0;6;82;303;385
782;90;17;97;15;6;15;225;240
783;229;27;71;13;3;34;343;377
784;2;5;9;28;6;28;50;78
785;563;50;774;28;31;187;1446;1633
786;115;27;44;4;146;139;336;475
787;56;0;11;0;0;8;67;75
788;316;58;161;76;51;135;662;797
789;556;54;845;202;133;63;1790;1853
790;24;1;108;29;29;14;191;205
791;494;92;391;194;11;241;1182;1423
792;756;138;354;160;169;61;1577;1638
793;24;0;2;0;0;9;26;35
794;26;1;11;0;1;4;39;43
795;180;32;348;76;32;90;668;758
796;464;28;873;29;18;37;1412;1449
797;408;0;21;0;0;17;429;446
798;263;5;233;69;41;83;611;694
799;308;85;137;102;45;118;677;795
800;265;199;303;234;9;170;1010;1180
801;31;19;35;26;14;52;125;177
802;34;0;7;0;0;0;41;41
803;5;1;5;10;0;7;21;28
804;69;2;15;2;2;6;90;96
805;219;3;60;12;9;12;303;315
806;374;64;116;84;25;64;663;727
807;521;168;706;80;76;61;1551;1612
808;267;3;30;4;0;57;304;361
809;769;22;500;210;143;33;1644;1677
810;73;28;217;10;24;115;352;467
811;561;85;171;25;123;114;965;1079
812;19;6;20;0;5;12;50;62
813;492;0;37;7;0;42;536;578
814;12;1;3;0;0;7;16;23
815;2;1;1;1;0;1;5;6
816;30;9;12;2;11;30;64;94
817;479;28;136;75;14;35;732;767
818;22;3;18;0;0;11;43;54
819;29;0;29;0;5;4;63;67
820;674;168;108;192;42;231;1184;1415
821;347;44;534;17;0;26;942;968
822;284;3;84;4;7;23;382;405
823;192;5;53;0;5;15;255;270
824;1023;93;651;49;55;37;1871;1908
825;241;0;12;0;0;25;253;278
826;105;0;9;2;1;4;117;121
827;1394;22;708;89;91;182;2304;2486
828;631;28;491;30;14;56;1194;1250
829;508;124;249;50;38;134;969;1103
830;311;26;640;180;37;121;1194;1315
831;760;53;400;17;93;0;1323;1323
832;162;50;100;55;30;27;397;424
833;14;7;9;6;16;12;52;64
834;27;0;12;0;1;5;40;45
835;336;28;282;184;54;54;884;938
836;102;9;49;24;3;12;187;199
837;1296;17;311;45;69;51;1738;1789
838;29;0;25;2;2;3;58;61
839;53;0;8;0;0;2;61;63
840;80;4;46;0;17;2;147;149
841;46;7;59;2;4;27;118;145
842;27;2;10;0;0;1;39;40
843;3;6;7;0;0;3;16;19
844;391;32;70;21;32;16;546;562
845;393;5;136;7;5;27;546;573
846;600;20;350;29;30;33;1029;1062
847;574;8;216;21;16;33;835;868
848;379;4;93;12;9;98;497;595
849;218;63;282;137;35;70;735;805
850;454;0;171;8;19;32;652;684
851;29;12;59;19;1;36;120;156
852;66;0;16;0;6;20;88;108
853;1099;0;45;0;0;34;1144;1178
854;13;2;18;6;1;0;40;40
855;160;80;369;67;39;41;715;756
856;350;3;39;0;0;19;392;411
857;167;2;89;0;0;34;258;292
858;6;0;5;0;0;1;11;12
859;10;0;8;0;0;9;18;27
860;584;44;212;46;8;177;894;1071
861;743;19;181;12;0;200;955;1155
862;387;68;569;89;45;68;1158;1226
863;199;9;57;20;21;6;306;312
864;12;23;38;30;18;7;121;128
865;97;12;84;13;10;15;216;231
866;6;10;12;3;15;40;46;86
867;27;1;14;4;1;21;47;68
868;473;21;176;19;21;56;710;766
869;213;5;28;7;7;41;260;301
870;508;11;59;23;5;29;606;635
871;32;0;5;2;0;8;39;47
872;614;35;160;58;35;35;902;937
873;6;12;3;21;6;40;48;88
874;124;83;267;85;59;35;618;653
875;381;28;215;84;28;21;736;757
876;457;4;29;0;0;9;490;499
877;288;10;30;4;10;125;342;467
878;735;40;183;52;20;30;1030;1060
879;4;1;11;0;0;1;16;17
880;241;45;604;34;26;54;950;1004
881;516;56;449;86;33;16;1140;1156
882;604;28;674;91;28;28;1425;1453
883;5;4;8;2;0;5;19;24
884;210;0;6;0;0;2;216;218
885;197;107;227;7;59;131;597;728
886;24;2;20;2;2;10;50;60
887;897;161;430;186;161;27;1835;1862
888;441;35;83;7;29;11;595;606
889;0;2;3;4;1;5;10;15
890;15;0;8;4;2;20;29;49
891;899;0;101;0;0;20;1000;1020
892;9;1;5;0;0;1;15;16
893;795;0;545;95;58;0;1493;1493
894;451;0;39;0;4;24;494;518
895;897;126;196;91;112;37;1422;1459
896;384;25;292;130;41;64;872;936
897;627;91;597;159;91;15;1565;1580
898;709;45;115;30;160;45;1059;1104
899;19;13;18;10;7;8;67;75
900;2;3;6;4;1;9;16;25
901;108;1;28;13;1;4;151;155
902;571;12;523;63;60;24;1229;1253
903;70;54;109;80;9;45;322;367
904;244;8;32;7;2;50;293;343
905;46;35;69;84;41;66;275;341
906;397;19;69;12;0;9;497;506
907;158;19;288;25;0;38;490;528
908;7;10;13;3;11;11;44;55
909;1285;21;449;106;20;20;1881;1901
910;12;0;4;0;0;0;16;16
911;371;22;39;6;0;92;438;530
912;28;9;37;12;7;13;93;106
913;5;2;3;3;0;5;13;18
914;693;21;925;31;24;84;1694;1778
915;349;16;144;28;5;182;542;724
916;476;75;162;29;151;97;893;990
917;22;0;19;6;5;3;52;55
918;10;4;4;3;3;14;24;38
919;806;80;161;120;11;33;1178;1211
920;43;2;27;0;9;12;81;93
921;120;19;206;25;19;54;389;443
922;27;2;7;0;2;13;38;51
923;889;55;685;168;92;129;1889;2018
924;4;12;11;3;13;15;43;58
925;464;5;64;7;0;37;540;577
926;364;40;425;158;60;50;1047;1097
927;19;3;18;3;1;0;44;44
928;281;7;84;15;0;119;387;506
929;380;98;733;110;112;28;1433;1461
930;777;35;731;39;137;114;1719;1833
931;953;0;71;0;0;174;1024;1198
932;223;2;31;0;2;39;258;297
933;88;39;78;58;13;93;276;369
934;816;66;549;216;66;99;1713;1812
935;530;117;678;134;44;147;1503;1650
936;14;0;2;0;0;7;16;23
937;576;172;961;125;115;19;1949;1968
938;211;2;30;7;7;10;257;267
939;0;0;2;3;3;8;8;16
940;1;3;8;2;5;5;19;24
941;157;43;127;68;56;37;451;488
942;752;122;476;39;153;34;1542;1576
943;1224;28;140;0;14;168;1406;1574
944;397;46;288;20;38;70;789;859
945;392;5;91;28;26;112;542;654
946;162;6;37;6;13;13;224;237
947;1298;0;70;37;14;42;1419;1461
948;63;3;67;8;9;28;150;178
949;243;11;119;10;3;15;386;401
950;186;36;234;86;72;48;614;662
951;458;81;356;106;50;40;1051;1091
952;863;83;547;86;99;33;1678;1711
953;275;11;68;25;7;7;386;393
954;19;7;19;0;1;24;46;70
955;14;3;21;2;1;28;41;69
956;39;1;22;3;4;12;69;81
957;5;10;13;3;8;16;39;55
958;770;29;890;250;27;24;1966;1990
959;434;137;400;45;137;45;1153;1198
960;1279;15;287;20;0;15;1601;1616
961;1215;33;249;64;116;149;1677;1826
962;26;3;13;2;10;0;54;54
963;35;0;11;0;0;2;46;48
964;398;61;265;138;61;53;923;976
965;59;0;11;4;2;5;76;81
966;16;2;18;3;0;24;39;63
967;11;0;16;7;6;21;40;61
968;22;1;8;2;1;2;34;36
969;138;15;35;25;11;72;224;296
970;3;2;7;0;4;2;16;18
971;10;0;3;0;0;4;13;17
972;342;9;112;19;14;19;496;515
973;39;33;130;41;26;44;269;313
974;741;19;154;50;9;28;973;1001
975;16;5;30;8;7;26;66;92
976;88;39;54;64;28;153;273;426
977;1230;0;396;232;178;158;2036;2194
978;444;44;382;11;8;17;889;906
979;26;1;16;2;2;15;47;62
980;6;0;4;0;0;0;10;10
981;860;28;409;73;56;56;1426;1482
982;258;105;239;237;172;9;1011;1020
983;81;1;31;2;1;0;116;116
984;2;23;11;8;6;46;50;96
985;68;0;16;0;0;8;84;92
986;189;2;55;0;5;12;251;263
987;213;2;44;0;2;5;261;266
988;658;80;483;123;13;13;1357;1370
989;10;0;11;17;29;29;67;96
990;736;114;279;82;76;190;1287;1477
991;156;29;56;30;32;47;303;350
992;349;7;35;0;0;47;391;438
993;121;62;90;68;20;125;361;486
994;356;80;329;138;17;106;920;1026
995;154;20;66;0;12;27;252;279
996;230;35;75;63;57;31;460;491
997;45;3;9;4;4;7;65;72
998;48;0;2;0;0;5;50;55
999;4;12;15;19;7;12;57;69
1000;87;13;34;10;6;10;150;160
1001;6;2;15;6;6;3;35;38
1002;5;23;15;0;18;14;61;75
1003;230;14;156;82;24;58;506;564
1004;817;185;687;145;55;241;1889;2130
1005;63;0;21;7;0;12;91;103
1006;1308;0;396;23;0;0;1727;1727
1007;62;0;22;3;1;26;88;114
1008;359;0;134;13;26;123;532;655
1009;372;23;384;250;12;108;1041;1149
1010;4;12;5;3;16;17;40;57
1011;6;2;18;2;8;14;36;50
1012;515;47;267;62;66;38;957;995
1013;620;54;239;99;98;119;1110;1229
1014;202;5;74;11;5;14;297;311
1015;960;64;464;146;0;16;1634;1650
1016;13;4;20;0;0;1;37;38
1017;107;2;12;2;2;12;125;137
1018;1;45;3;4;6;42;59;101
1019;113;61;204;34;26;47;438;485
1020;871;111;704;145;55;166;1886;2052
1021;711;28;142;49;18;47;948;995
1022;7;23;78;133;49;144;290;434
1023;209;162;209;41;162;37;783;820
1024;760;80;466;17;13;80;1336;1416
1025;2;6;4;3;1;9;16;25
1026;11;0;13;2;4;11;30;41
1027;57;2;51;4;2;23;116;139
1028;16;2;18;2;1;5;39;44
1029;829;138;430;60;92;15;1549;1564
1030;74;0;42;2;1;6;119;125
1031;35;40;111;36;40;12;262;274
1032;3;0;5;13;0;1;21;22
1033;471;0;510;99;21;12;1101;1113
1034;462;0;24;6;0;4;492;496
1035;184;2;19;8;8;4;221;225
1036;852;60;207;78;36;48;1233;1281
1037;408;61;109;48;122;41;748;789
1038;146;0;93;7;13;73;259;332
1039;35;3;20;4;1;20;63;83
1040;42;0;17;0;0;18;59;77
1041;31;9;27;16;9;33;92;125
1042;38;0;2;0;0;6;40;46
1043;1050;178;555;77;138;118;1998;2116
1044;407;28;100;120;74;18;729;747
1045;37;0;17;0;0;3;54;57
1046;964;34;137;15;0;11;1150;1161
1047;22;2;10;6;4;34;44;78
1048;315;26;473;220;12;182;1046;1228
1049;51;1;7;2;1;25;62;87
1050;13;0;3;0;0;0;16;16
1051;968;147;842;137;42;210;2136;2346
1052;171;45;73;59;10;90;358;448
1053;4;0;16;17;4;4;41;45
1054;62;1;16;3;2;6;84;90
1055;318;8;407;150;35;8;918;926
1056;283;112;151;51;72;125;669;794
1057;12;2;20;3;2;5;39;44
1058;10;5;28;11;1;8;55;63
1059;952;12;180;47;12;12;1203;1215
1060;15;20;25;2;7;26;69;95
1061;819;0;72;12;0;63;903;966
1062;618;15;106;20;7;45;766;811
1063;274;0;21;4;6;15;305;320
1064;483;74;114;169;37;18;877;895
1065;812;99;431;237;149;33;1728;1761
1066;20;2;9;4;6;20;41;61
1067;1;4;3;8;9;7;25;32
1068;23;17;23;43;20;9;126;135
1069;8;0;8;0;0;2;16;18
1070;729;17;133;11;0;195;890;1085
1071;1206;55;445;168;18;18;1892;1910
1072;1;2;5;6;0;3;14;17
1073;11;7;12;2;2;27;34;61
1074;1001;44;107;58;44;44;1254;1298
1075;738;0;232;13;20;50;1003;1053
1076;572;8;259;34;35;80;908;988
1077;262;6;61;0;10;102;339;441
1078;26;0;15;2;1;2;44;46
1079;110;5;137;26;23;29;301;330
1080;341;142;113;259;151;66;1006;1072
1081;517;12;54;16;6;120;605;725
1082;779;86;537;34;69;138;1505;1643
1083;30;5;24;6;3;8;68;76
1084;303;0;280;60;147;15;790;805
1085;10;7;25;6;3;7;51;58
1086;9;1;7;0;3;2;20;22
1087;545;7;114;37;21;78;724;802
1088;277;21;64;62;21;25;445;470
1089;267;98;606;48;70;98;1089;1187
1090;86;12;75;33;15;6;221;227
1091;165;3;147;4;24;41;343;384
1092;97;1;19;2;0;11;119;130
1093;63;6;57;13;13;22;152;174
1094;558;79;622;207;175;95;1641;1736
1095;1111;24;790;160;45;172;2130;2302
1096;30;0;11;0;0;3;41;44
1097;6;5;4;13;4;25;32;57
1098;318;3;17;4;7;56;349;405
1099;565;42;548;64;83;99;1302;1401
1100;1099;0;45;0;0;34;1144;1178
1101;7;7;14;7;16;15;51;66
1102;815;8;53;11;0;70;887;957
1103;354;21;311;167;75;32;928;960
1104;4;6;8;6;3;10;27;37
1105;170;6;97;24;12;88;309;397
1106;5;0;8;2;0;0;15;15
1107;13;6;7;0;3;3;29;32
1108;183;5;65;3;5;49;261;310
1109;4;0;5;0;1;5;10;15
1110;163;0;480;0;126;75;769;844
1111;6;1;2;2;0;4;11;15
1112;56;0;14;0;0;2;70;72
1113;546;72;376;94;145;72;1233;1305
1114;622;7;115;30;0;15;774;789
1115;918;57;842;99;38;133;1954;2087
1116;691;7;69;0;7;23;774;797
1117;1253;0;447;23;71;35;1794;1829
1118;606;7;155;10;0;54;778;832
1119;6;4;14;8;8;22;40;62
1120;32;0;8;23;4;18;67;85
1121;97;4;44;6;1;18;152;170
1122;34;6;21;11;4;8;76;84
1123;8;4;20;6;3;16;41;57
1124;52;0;9;0;0;1;61;62
1125;12;0;5;0;0;4;17;21
1126;823;25;459;124;29;95;1460;1555
1127;110;5;59;7;1;7;182;189
1128;266;6;51;8;6;64;337;401
1129;167;13;180;86;13;70;459;529
1130;717;42;864;219;30;84;1872;1956
1131;543;10;205;160;143;82;1061;1143
1132;371;17;238;23;24;106;673;779
1133;997;15;414;99;30;76;1555;1631
1134;11;0;3;0;0;1;14;15
1135;2;4;2;0;11;5;19;24
1136;1142;29;249;38;29;14;1487;1501
1137;82;33;54;71;30;41;270;311
1138;652;8;158;21;0;142;839;981
1139;139;13;78;20;13;36;263;299
1140;62;1;57;19;11;48;150;198
1141;67;11;26;4;3;262;111;373
1142;23;0;11;2;1;3;37;40
1143;2;1;1;0;0;1;4;5
1144;1074;0;69;0;0;46;1143;1189
1145;5;0;4;0;0;1;9;10
1146;152;9;121;12;12;45;306;351
1147;25;3;16;8;5;2;57;59
1148;6;7;4;3;4;6;24;30
1149;27;5;8;8;3;12;51;63
1150;4;1;7;2;1;2;15;17
1151;254;7;108;20;0;26;389;415
1152;1166;0;48;0;0;36;1214;1250
1153;490;0;184;10;28;21;712;733
1154;588;7;76;110;15;15;796;811
1155;790;19;133;12;0;19;954;973
1156;231;161;215;171;30;53;808;861
1157;491;48;231;112;105;134;987;1121
1158;91;3;52;2;1;31;149;180
1159;1067;138;750;0;19;39;1974;2013
1160;358;108;413;141;97;32;1117;1149
1161;95;11;35;0;4;7;145;152
1162;480;86;249;75;86;144;976;1120
1163;5;4;10;2;2;7;23;30
1164;152;27;103;106;54;81;442;523
1165;641;7;84;0;30;38;762;800
1166;100;64;79;65;0;109;308;417
1167;771;51;154;54;10;154;1040;1194
1168;882;29;514;38;29;44;1492;1536
1169;332;194;377;149;125;57;1177;1234
1170;345;53;528;98;75;97;1099;1196
1171;166;5;107;11;8;29;297;326
1172;134;11;59;15;2;30;221;251
1173;15;8;16;11;5;22;55;77
1174;615;28;259;12;48;30;962;992
1175;201;2;43;3;5;35;254;289
1176;143;6;52;11;8;17;220;237
1177;53;8;17;13;0;21;91;112
1178;944;0;60;0;0;30;1004;1034
1179;1004;59;265;115;59;27;1502;1529
1180;18;3;19;3;3;6;46;52
1181;1302;68;731;89;114;45;2304;2349
1182;173;8;107;7;2;176;297;473
1183;2;3;10;11;2;10;28;38
1184;97;1;41;6;2;41;147;188
1185;8;15;27;0;20;33;70;103
1186;794;73;573;0;29;14;1469;1483
1187;548;31;422;0;112;28;1113;1141
1188;8;0;9;2;1;3;20;23
1189;18;0;9;0;1;11;28;39
1190;7;10;13;16;0;4;46;50
1191;51;4;24;4;7;1;90;91
1192;1;6;2;3;6;3;18;21
1193;420;0;452;182;64;140;1118;1258
1194;784;48;560;42;176;48;1610;1658
1195;29;4;34;2;4;4;73;77
1196;20;2;14;3;0;10;39;49
1197;6;5;17;3;24;46;55;101
1198;342;32;230;34;32;40;670;710
1199;1205;0;235;19;14;205;1473;1678
1200;336;130;411;240;32;43;1149;1192
1201;153;64;123;116;64;14;520;534
1202;1;2;7;4;3;11;17;28
1203;261;42;144;55;48;133;550;683
1204;714;76;395;116;0;12;1301;1313
1205;133;27;421;13;195;71;789;860
1206;2;3;12;3;5;7;25;32
1207;182;17;259;77;70;29;605;634
1208;46;1;12;3;0;9;62;71
1209;2;13;6;7;5;11;33;44
1210;693;21;118;110;147;42;1089;1131
1211;674;62;134;0;26;8;896;904
1212;365;3;15;4;3;11;390;401
1213;371;32;189;0;58;6;650;656
1214;30;0;10;2;0;5;42;47
1215;938;19;843;25;95;38;1920;1958
1216;5;13;14;0;5;31;37;68
1217;329;35;222;130;35;43;751;794
1218;135;25;51;23;25;46;259;305
1219;57;0;27;0;0;36;84;120
1220;229;5;56;3;2;20;295;315
1221;386;23;95;54;41;196;599;795
1222;14;36;11;3;26;35;90;125
1223;73;57;100;71;15;0;316;316
1224;296;13;104;11;13;17;437;454
1225;557;129;984;193;37;18;1900;1918
1226;15;0;2;0;0;6;17;23
1227;5;36;7;0;10;45;58;103
1228;68;8;18;19;8;12;121;133
1229;280;0;18;0;0;24;298;322
1230;411;106;147;54;115;66;833;899
1231;443;10;75;0;10;48;538;586
1232;26;2;19;10;5;8;62;70
1233;459;0;24;6;0;4;489;493
1234;23;0;26;7;15;3;71;74
1235;100;2;16;2;1;31;121;152
1236;5;6;15;11;7;13;44;57
1237;711;36;217;172;96;168;1232;1400
1238;104;20;101;24;15;5;264;269
1239;9;0;3;0;0;1;12;13
1240;293;0;87;4;11;23;395;418
1241;736;63;946;219;189;126;2153;2279
1242;9;3;15;2;3;2;32;34
1243;95;14;64;2;9;38;184;222
1244;422;7;238;69;46;15;782;797
1245;2;4;9;10;5;16;30;46
1246;9;0;7;2;0;4;18;22
1247;204;5;39;17;0;89;265;354
1248;9;1;4;3;2;3;19;22
1249;982;17;672;23;34;51;1728;1779
1250;836;185;575;24;25;77;1645;1722
1251;431;82;441;80;20;102;1054;1156
1252;7;11;3;10;4;20;35;55
1253;79;1;31;4;4;12;119;131
1254;5;1;7;2;1;4;16;20
1255;244;51;270;101;0;45;666;711
1256;84;10;34;11;10;28;149;177
1257;14;0;23;4;5;19;46;65
1258;100;2;128;23;7;10;260;270
1259;774;70;118;182;187;93;1331;1424
1260;508;5;21;7;5;10;546;556
1261;368;24;68;38;0;88;498;586
1262;507;93;520;242;40;26;1402;1428
1263;1000;0;76;0;0;10;1076;1086
1264;556;14;717;210;0;43;1497;1540
1265;1142;51;415;90;69;37;1767;1804
1266;689;8;167;11;8;88;883;971
1267;38;4;22;3;3;3;70;73
1268;52;12;50;4;36;55;154;209
1269;378;97;259;197;194;34;1125;1159
1270;18;3;17;3;0;4;41;45
1271;1;5;8;4;8;20;26;46
1272;191;56;139;51;8;100;445;545
1273;1171;43;219;19;14;47;1466;1513
1274;160;15;196;15;11;50;397;447
1275;972;19;595;180;26;138;1792;1930
1276;313;15;47;20;0;192;395;587
1277;448;40;469;80;0;91;1037;1128
1278;56;0;12;0;0;18;68;86
1279;966;168;672;246;105;126;2157;2283
1280;1;1;3;1;1;1;7;8
1281;6;0;5;2;1;2;14;16
1282;10;0;10;3;1;7;24;31
1283;513;7;133;46;14;14;713;727
1284;66;2;40;4;3;14;115;129
1285;68;28;39;16;30;41;181;222
1286;129;26;67;3;67;2;292;294
1287;488;21;238;56;108;28;911;939
1288;751;127;687;20;15;31;1600;1631
1289;553;25;142;65;67;8;852;860
1290;10;17;18;8;26;40;79;119
1291;99;27;102;28;48;6;304;310
1292;290;59;177;77;5;29;608;637
1293;158;11;99;15;11;17;294;311
1294;283;10;38;0;13;27;344;371
1295;20;4;10;6;4;17;44;61
1296;992;24;694;51;19;119;1780;1899
1297;159;2;51;6;2;24;220;244
1298;3;18;26;11;8;12;66;78
1299;406;0;30;0;0;8;436;444
1300;587;54;348;71;54;130;1114;1244
1301;20;3;16;0;4;1;43;44
1302;10;12;12;25;1;20;60;80
1303;10;14;29;4;2;36;59;95
1304;856;0;76;12;9;199;953;1152
1305;105;0;10;0;1;0;116;116
1306;98;1;17;0;1;5;117;122
1307;14;0;2;0;0;7;16;23
1308;5;1;8;0;0;1;14;15
1309;72;7;58;13;1;24;151;175
1310;675;0;85;10;7;77;777;854
1311;399;27;159;58;8;39;651;690
1312;10;1;7;0;0;1;18;19
1313;238;115;215;169;69;76;806;882
1314;629;0;70;0;0;35;699;734
1315;215;7;33;3;0;13;258;271
1316;29;0;5;0;1;5;35;40
1317;51;4;50;12;1;49;118;167
1318;16;2;11;3;0;16;32;48
1319;40;1;40;4;3;18;88;106
1320;347;0;35;4;3;7;389;396
1321;25;1;13;0;0;3;39;42
1322;482;35;553;72;160;17;1302;1319
1323;443;5;71;21;16;82;556;638
1324;7;0;1;0;0;0;8;8
1325;5;4;5;4;2;10;20;30
1326;7;10;17;8;6;13;48;61
1327;151;81;86;168;91;64;577;641
1328;33;87;64;175;16;74;375;449
1329;19;1;17;2;0;2;39;41
1330;56;10;92;19;7;25;184;209
1331;4;16;20;0;17;20;57;77
1332;217;77;373;111;23;93;801;894
1333;88;3;21;4;1;29;117;146
1334;3;17;26;20;1;39;67;106
1335;846;84;352;91;56;42;1429;1471
1336;1449;89;161;69;35;107;1803;1910
1337;169;24;553;188;0;144;934;1078
1338;293;35;179;46;59;65;612;677
1339;313;8;104;6;4;126;435;561
1340;460;35;422;33;12;153;962;1115
1341;2;12;10;6;13;30;43;73
1342;8;4;12;15;4;29;43;72
1343;24;1;10;2;0;4;37;41
1344;279;172;74;38;8;246;571;817
1345;227;151;573;98;54;31;1103;1134
1346;109;18;16;24;26;18;193;211
1347;378;0;88;19;4;73;489;562
1348;11;1;2;2;1;6;17;23
1349;714;8;99;11;0;47;832;879
1350;1083;108;649;253;151;108;2244;2352
1351;30;1;8;0;0;3;39;42
1352;123;17;171;39;0;30;350;380
1353;910;111;724;49;74;55;1868;1923
1354;216;2;6;0;0;9;224;233
1355;703;102;601;0;58;43;1464;1507
1356;33;4;24;4;2;5;67;72
1357;234;14;77;19;10;42;354;396
1358;69;8;26;12;7;12;122;134
1359;50;1;27;6;7;1;91;92
1360;595;71;153;120;112;41;1051;1092
1361;403;24;29;6;24;218;486;704
1362;505;72;270;36;27;54;910;964
1363;1016;12;215;16;12;63;1271;1334
1364;221;104;169;102;78;84;674;758
1365;9;1;5;4;5;7;24;31
1366;123;133;142;71;44;88;513;601
1367;267;38;701;149;165;63;1320;1383
1368;14;0;6;0;0;0;20;20
1369;252;98;827;219;70;196;1466;1662
1370;16;0;23;3;2;10;44;54
1371;14;0;3;0;0;1;17;18
1372;73;0;13;0;1;0;87;87
1373;173;26;255;35;71;81;560;641
1374;209;0;40;3;2;15;254;269
1375;1;6;2;8;2;12;19;31
1376;230;48;214;13;32;75;537;612
1377;27;0;10;0;0;4;37;41
1378;167;2;44;6;2;19;221;240
1379;158;0;76;13;7;71;254;325
1380;340;21;134;258;14;56;767;823
1381;11;12;35;3;5;12;66;78
1382;12;4;19;12;6;14;53;67
1383;6;0;3;0;0;1;9;10
1384;60;51;87;6;20;51;224;275
1385;3;1;3;8;0;5;15;20
1386;631;0;115;10;7;30;763;793
1387;243;131;217;85;6;26;682;708
1388;23;1;6;0;0;2;30;32
1389;1259;172;815;97;148;33;2491;2524
1390;8;3;9;19;4;22;43;65
1391;11;1;4;2;0;7;18;25
1392;8;0;14;2;3;7;27;34
1393;532;21;127;26;20;20;726;746
1394;29;0;2;0;0;1;31;32
1395;957;47;494;82;47;95;1627;1722
1396;37;0;17;0;0;3;54;57
1397;7;1;6;0;3;3;17;20
1398;5;1;7;17;14;11;44;55
1399;438;169;565;91;169;70;1432;1502
1400;12;1;21;2;2;3;38;41
1401;44;5;19;0;4;19;72;91
1402;344;35;178;15;23;17;595;612
1403;376;0;38;11;8;69;433;502
1404;612;91;520;258;107;107;1588;1695
1405;22;1;11;0;5;3;39;42
1406;423;184;368;13;97;21;1085;1106
1407;90;67;165;30;43;11;395;406
1408;465;71;250;93;35;62;914;976
1409;5;3;9;6;2;6;25;31
1410;112;1;54;7;7;36;181;217
1411;7;2;6;2;0;3;17;20
1412;531;69;300;150;138;150;1188;1338
1413;387;126;342;0;45;180;900;1080
1414;136;1;12;0;3;32;152;184
1415;30;5;22;8;9;28;74;102
1416;17;0;9;0;0;1;26;27
1417;16;1;2;0;0;1;19;20
1418;34;1;14;0;0;5;49;54
1419;46;0;30;12;1;30;89;119
1420;298;7;68;4;0;19;377;396
1421;41;0;17;3;1;16;62;78
1422;275;0;86;10;23;66;394;460
1423;6;8;19;16;4;4;53;57
1424;582;0;65;0;0;13;647;660
1425;267;42;309;55;42;21;715;736
1426;140;3;29;4;5;14;181;195
1427;532;88;168;69;44;133;901;1034
1428;1156;120;915;94;144;96;2429;2525
1429;87;5;71;7;12;29;182;211
1430;123;1;26;2;0;72;152;224
1431;402;35;106;101;77;42;721;763
1432;479;35;179;28;7;85;728;813
1433;635;114;254;132;152;76;1287;1363
1434;56;19;29;2;14;25;120;145
1435;459;15;171;142;23;31;810;841
1436;6;17;16;6;16;42;61;103
1437;251;108;334;65;92;117;850;967
1438;503;27;419;90;139;153;1178;1331
1439;600;21;128;223;150;128;1122;1250
1440;40;3;30;10;7;11;90;101
1441;303;23;751;82;26;191;1185;1376
1442;35;0;4;0;0;0;39;39
1443;73;18;66;7;12;2;176;178
1444;5;3;4;4;1;0;17;17
1445;462;61;184;10;53;107;770;877
1446;3;1;8;23;2;18;37;55
1447;291;10;689;84;10;0;1084;1084
1448;376;53;462;168;53;53;1112;1165
1449;369;9;87;12;14;34;491;525
1450;71;99;278;185;121;38;754;792
1451;5;0;3;0;0;1;8;9
1452;70;6;69;2;3;3;150;153
1453;708;7;62;0;0;15;777;792
1454;1;3;4;2;3;11;13;24
1455;21;0;3;0;0;0;24;24
1456;373;14;83;6;9;19;485;504
1457;734;22;350;151;25;100;1282;1382
1458;46;0;40;3;0;3;89;92
1459;362;17;398;80;35;61;892;953
1460;962;12;194;16;24;12;1208;1220
1461;483;0;108;0;6;36;597;633
1462;127;4;73;15;6;11;225;236
1463;2;2;1;3;1;2;9;11
1464;980;37;265;35;163;31;1480;1511
1465;172;10;125;21;13;16;341;357
1466;324;132;693;27;118;88;1294;1382
1467;267;140;599;34;12;127;1052;1179
1468;56;0;9;0;0;3;65;68
1469;135;1;41;10;1;67;188;255
1470;292;30;415;63;33;200;833;1033
1471;544;13;85;8;6;29;656;685
1472;1;5;3;7;4;8;20;28
1473;979;44;935;29;25;22;2012;2034
1474;387;84;141;73;35;162;720;882
1475;176;29;818;0;33;112;1056;1168
1476;206;0;46;3;2;12;257;269
1477;312;21;206;102;92;149;733;882
1478;733;9;180;12;19;66;953;1019
1479;134;8;76;6;0;11;224;235
1480;367;17;241;104;188;232;917;1149
1481;22;3;30;0;5;15;60;75
1482;1493;86;454;112;43;43;2188;2231
1483;112;10;107;30;0;20;259;279
1484;268;11;88;15;3;22;385;407
1485;494;5;82;7;0;100;588;688
1486;918;21;118;13;10;21;1080;1101
1487;50;4;28;6;3;26;91;117
1488;15;0;11;0;2;9;28;37
1489;71;0;18;0;0;13;89;102
1490;13;3;6;6;5;6;33;39
1491;3;4;7;15;8;11;37;48
1492;67;4;32;17;2;16;122;138
1493;18;42;24;15;20;18;119;137
1494;22;2;31;7;4;5;66;71
1495;380;0;47;6;0;34;433;467
1496;247;161;295;210;85;47;998;1045
1497;11;0;10;0;2;20;23;43
1498;293;0;124;179;97;52;693;745
1499;14;0;16;0;0;6;30;36
1500;704;129;853;120;74;111;1880;1991
1501;71;22;112;138;89;29;432;461
1502;80;1;37;0;1;3;119;122
1503;621;73;414;78;48;85;1234;1319
1504;1156;120;915;94;144;96;2429;2525
1505;267;6;54;8;3;50;338;388
1506;199;12;31;3;12;7;257;264
1507;45;2;26;4;1;1;78;79
1508;3;9;4;7;8;7;31;38
1509;0;4;7;11;10;15;32;47
1510;30;11;33;13;6;29;93;122
1511;1060;61;835;80;20;101;2056;2157
1512;163;48;90;0;45;52;346;398
1513;38;1;24;0;0;0;63;63
1514;93;1;21;0;4;25;119;144
1515;861;31;558;62;95;79;1607;1686
1516;463;96;333;168;53;10;1113;1123
1517;298;27;697;216;24;166;1262;1428
1518;1;12;9;0;14;7;36;43
1519;24;2;23;0;8;24;57;81
1520;1148;0;60;0;0;24;1208;1232
1521;29;3;30;3;2;9;67;76
1522;75;12;141;43;39;187;310;497
1523;1459;0;61;0;15;215;1535;1750
1524;172;3;115;16;0;18;306;324
1525;538;13;91;17;6;26;665;691
1526;19;0;5;0;0;8;24;32
1527;674;92;736;39;0;92;1541;1633
1528;690;117;499;76;102;88;1484;1572
1529;80;1;60;4;6;16;151;167
1530;12;1;6;0;1;5;20;25
1531;928;63;254;0;12;12;1257;1269
1532;940;44;396;0;88;58;1468;1526
1533;734;26;70;11;44;17;885;902
1534;7;4;23;7;0;11;41;52
1535;5;7;31;15;4;7;62;69
1536;920;138;168;36;46;30;1308;1338
1537;9;0;5;0;0;7;14;21
1538;35;0;4;0;0;10;39;49
1539;18;2;10;0;0;25;30;55
1540;87;3;25;3;2;13;120;133
1541;16;14;36;37;22;48;125;173
1542;31;0;6;2;1;5;40;45
1543;30;5;23;4;1;4;63;67
1544;44;2;11;2;3;7;62;69
1545;43;5;28;7;6;33;89;122
1546;18;0;5;0;0;11;23;34
1547;38;0;12;3;1;1;54;55
1548;342;51;936;207;35;26;1571;1597
1549;986;36;168;16;0;108;1206;1314
1550;81;4;33;5;2;291;125;416
1551;8;0;3;0;0;1;11;12
1552;179;21;273;0;21;63;494;557
1553;482;147;509;104;107;107;1349;1456
1554;653;17;170;34;26;17;900;917
1555;194;2;56;0;0;0;252;252
1556;488;23;71;15;0;59;597;656
1557;453;38;279;188;38;183;996;1179
1558;5;0;1;1;1;1;8;9
1559;292;51;981;224;23;17;1571;1588
1560;28;0;13;4;2;8;47;55
1561;309;3;24;4;3;20;343;363
1562;2;10;11;12;9;20;44;64
1563;37;4;24;16;9;9;90;99
1564;2;6;28;13;4;16;53;69
1565;28;0;11;0;0;9;39;48
1566;138;120;204;16;126;60;604;664
1567;3;2;10;3;0;2;18;20
1568;204;97;97;21;118;26;537;563
1569;383;0;53;6;4;40;446;486
1570;965;34;586;89;86;37;1760;1797
1571;284;0;52;8;3;20;347;367
1572;9;7;13;3;2;20;34;54
1573;938;142;754;159;81;183;2074;2257
1574;533;10;217;198;174;195;1132;1327
1575;199;33;60;8;3;15;303;318
1576;2;8;8;6;1;9;25;34
1577;1073;0;250;153;14;14;1490;1504
1578;56;5;24;4;0;3;89;92
1579;172;73;93;95;78;34;511;545
1580;159;0;22;2;1;31;184;215
1581;13;2;15;2;2;8;34;42
1582;46;0;12;0;2;23;60;83
1583;75;12;141;43;39;187;310;497
1584;209;19;456;160;142;66;986;1052
1585;166;75;96;119;107;59;563;622
1586;777;30;163;0;51;122;1021;1143
1587;536;27;590;38;107;67;1298;1365
1588;412;172;153;150;105;57;992;1049
1589;686;17;142;23;26;35;894;929
1590;560;21;442;29;44;29;1096;1125
1591;322;53;899;34;40;53;1348;1401
1592;1073;0;629;145;37;37;1884;1921
1593;153;4;56;0;9;31;222;253
1594;31;1;8;0;0;8;40;48
1595;198;2;43;0;12;20;255;275
1596;48;0;14;0;0;6;62;68
1597;2;1;4;3;1;2;11;13
1598;12;3;8;8;0;17;31;48
1599;135;0;10;0;4;36;149;185
1600;97;3;66;12;7;34;185;219
1601;502;19;132;0;6;26;659;685
1602;18;10;3;3;5;0;39;39
1603;178;3;85;71;66;58;403;461
1604;63;6;57;13;13;22;152;174
1605;539;169;816;20;0;30;1544;1574
1606;1;8;6;4;8;16;27;43
1607;666;35;124;69;8;26;902;928
1608;572;8;232;23;62;17;897;914
1609;313;15;47;20;0;192;395;587
1610;707;20;171;65;60;50;1023;1073
1611;520;20;367;39;81;40;1027;1067
1612;100;71;243;108;94;219;616;835
1613;407;114;445;181;165;203;1312;1515
1614;239;7;119;4;15;11;384;395
1615;173;13;131;32;3;6;352;358
1616;712;50;420;65;38;38;1285;1323
1617;0;0;0;6;2;6;8;14
1618;8;4;15;3;5;3;35;38
1619;941;14;397;76;58;176;1486;1662
1620;23;4;5;10;5;23;47;70
1621;664;9;240;50;19;57;982;1039
1622;154;22;202;39;30;8;447;455
1623;284;16;160;84;16;134;560;694
1624;1121;0;72;0;12;12;1205;1217
1625;12;1;16;4;1;3;34;37
1626;1045;61;338;60;46;46;1550;1596
1627;1252;0;465;46;35;0;1798;1798
1628;407;70;239;103;88;53;907;960
1629;86;4;56;2;4;7;152;159
1630;17;0;2;0;0;2;19;21
1631;758;12;385;33;89;89;1277;1366
1632;710;15;30;20;0;0;775;775
1633;8;0;5;0;3;6;16;22
1634;1218;107;304;23;143;33;1795;1828
1635;255;43;134;37;14;24;483;507
1636;315;35;322;46;7;143;725;868
1637;200;193;100;46;185;185;724;909
1638;8;2;4;0;0;1;14;15
1639;1003;34;536;134;51;34;1758;1792
1640;1285;105;653;28;21;0;2092;2092
1641;22;4;17;12;10;13;65;78
1642;306;5;109;21;109;92;550;642
1643;1324;27;119;71;108;27;1649;1676
1644;102;1;15;2;0;24;120;144
1645;68;1;13;3;5;13;90;103
1646;14;10;29;4;7;15;64;79
1647;15;1;23;0;5;1;44;45
1648;15;0;6;0;1;12;22;34
1649;1020;31;430;62;63;79;1606;1685
1650;202;2;46;3;2;10;255;265
1651;8;1;5;0;0;1;14;15
1652;338;4;89;11;8;13;450;463
1653;167;48;602;63;72;72;952;1024
1654;1193;33;281;129;66;33;1702;1735
1655;158;6;45;8;2;2;219;221
1656;239;13;143;45;4;52;444;496
1657;2;2;4;13;13;4;34;38
1658;499;149;815;173;49;49;1685;1734
1659;106;27;68;52;7;5;260;265
1660;384;60;364;119;101;232;1028;1260
1661;216;9;57;20;9;125;311;436
1662;446;107;768;33;196;53;1550;1603
1663;505;137;401;104;22;22;1169;1191
1664;754;160;625;63;32;48;1634;1682
1665;368;32;639;13;43;10;1095;1105
1666;110;29;92;28;10;145;269;414
1667;2;4;9;0;4;5;19;24
1668;381;35;172;56;86;93;730;823
1669;128;0;16;0;1;4;145;149
1670;353;61;753;40;46;27;1253;1280
1671;350;104;189;197;151;57;991;1048
1672;1050;14;322;0;14;112;1400;1512
1673;51;23;82;33;0;42;189;231
1674;208;17;76;36;17;38;354;392
1675;820;57;242;45;0;11;1164;1175
1676;2;7;11;16;12;27;48;75
1677;244;15;108;4;15;50;386;436
1678;36;4;18;6;2;18;66;84
1679;199;66;315;97;174;41;851;892
1680;652;48;350;94;84;108;1228;1336
1681;19;1;14;3;2;4;39;43
1682;255;47;573;52;32;15;959;974
1683;6;2;3;1;262;3;274;277
1684;631;43;239;128;76;21;1117;1138
1685;753;43;226;69;10;204;1101;1305
1686;22;1;9;0;0;14;32;46
1687;527;24;230;32;24;65;837;902
1688;379;6;157;25;91;91;658;749
1689;68;6;38;3;6;41;121;162
1690;33;8;10;2;10;3;63;66
1691;331;197;170;58;152;35;908;943
1692;15;5;14;0;4;11;38;49
1693;555;82;257;93;61;61;1048;1109
1694;8;3;19;0;2;3;32;35
1695;1184;102;673;52;40;40;2051;2091
1696;605;10;345;84;54;32;1098;1130
1697;581;49;157;43;8;108;838;946
1698;13;3;17;7;3;3;43;46
1699;2;7;5;2;15;27;31;58
1700;272;7;80;20;7;11;386;397
1701;539;6;91;8;6;97;650;747
1702;85;0;3;0;0;7;88;95
1703;19;3;6;4;2;12;34;46
1704;158;35;179;0;0;125;372;497
1705;584;100;835;65;83;35;1667;1702
1706;526;80;553;123;94;53;1376;1429
1707;8;0;7;3;1;1;19;20
1708;19;5;12;10;3;19;49;68
1709;9;1;24;2;1;2;37;39
1710;46;4;36;2;2;1;90;91
1711;620;16;165;0;24;82;825;907
1712;322;3;50;4;3;42;382;424
1713;707;44;603;95;58;29;1507;1536
1714;625;38;242;50;34;76;989;1065
1715;344;45;654;104;11;114;1158;1272
1716;6;3;12;6;1;0;28;28
1717;61;0;3;0;0;7;64;71
1718;163;23;424;27;65;76;702;778
1719;240;90;216;63;6;24;615;639
1720;172;41;86;45;6;27;350;377
1721;389;66;408;37;57;85;957;1042
1722;1462;16;128;0;0;160;1606;1766
1723;22;0;6;6;2;6;36;42
1724;1181;26;120;17;13;39;1357;1396
1725;173;2;39;3;2;47;219;266
1726;279;0;18;0;0;9;297;306
1727;185;8;133;56;56;12;438;450
1728;162;31;127;8;17;69;345;414
1729;174;77;203;6;24;97;484;581
1730;489;6;152;8;6;132;661;793
1731;355;30;177;90;138;30;790;820
1732;811;76;428;99;137;107;1551;1658
1733;1315;22;780;145;0;178;2262;2440
1734;141;8;129;3;11;47;292;339
1735;274;83;216;151;141;224;865;1089
1736;520;8;223;32;49;42;832;874
1737;45;0;16;2;1;6;64;70
1738;145;193;459;205;26;145;1028;1173
1739;913;26;376;17;26;13;1358;1371
1740;448;71;951;40;17;17;1527;1544
1741;21;1;9;7;3;5;41;46
1742;15;4;13;0;0;19;32;51
1743;8;3;19;3;3;8;36;44
1744;11;0;36;15;5;12;67;79
1745;21;8;20;15;3;9;67;76
1746;972;59;913;25;19;59;1988;2047
1747;637;47;237;12;19;76;952;1028
1748;493;183;352;184;23;28;1235;1263
1749;25;4;9;6;8;32;52;84
1750;957;40;175;158;53;107;1383;1490
1751;5;17;17;13;14;34;66;100
1752;512;53;98;81;179;89;923;1012
1753;15;0;8;4;2;20;29;49
1754;63;151;137;153;19;53;523;576
1755;1017;50;500;65;50;133;1682;1815
1756;213;9;76;4;3;30;305;335
1757;739;107;309;140;80;35;1375;1410
1758;175;10;110;54;6;27;355;382
1759;188;3;180;20;3;43;394;437
1760;957;153;612;99;95;153;1916;2069
1761;953;0;71;0;0;174;1024;1198
1762;145;1;33;2;1;1;182;183
1763;423;42;706;73;197;197;1441;1638
1764;4;9;16;17;0;12;46;58
1765;37;0;7;3;0;3;47;50
1766;896;10;101;13;10;34;1030;1064
1767;58;0;18;2;0;10;78;88
1768;159;0;120;0;0;137;279;416
1769;830;59;968;51;79;19;1987;2006
1770;23;0;15;0;2;7;40;47
1771;18;0;6;3;3;5;30;35
1772;233;0;23;0;0;12;256;268
1773;167;37;64;49;34;116;351;467
1774;995;112;417;42;48;41;1614;1655
1775;630;26;611;44;18;54;1329;1383
1776;4;2;12;7;5;26;30;56
1777;20;0;14;7;3;1;44;45
1778;17;3;18;3;4;18;45;63
1779;217;38;350;111;85;15;801;816
1780;25;6;16;20;0;5;67;72
1781;157;6;39;6;13;75;221;296
1782;18;7;34;10;2;3;71;74
1783;760;38;104;50;9;38;961;999
1784;641;7;56;0;0;28;704;732
1785;673;0;199;37;47;26;956;982
1786;539;30;92;80;46;38;787;825
1787;144;0;7;0;0;6;151;157
1788;726;53;363;123;107;161;1372;1533
1789;15;0;4;0;0;2;19;21
1790;593;30;91;29;22;7;765;772
1791;742;28;152;25;9;57;956;1013
1792;201;53;172;116;77;83;619;702
1793;35;3;67;10;8;24;123;147
1794;256;34;103;90;29;49;512;561
1795;29;1;17;0;3;13;50;63
1796;3;3;14;15;21;10;56;66
1797;48;9;45;3;15;20;120;140
1798;45;12;52;25;22;13;156;169
1799;189;10;253;56;43;64;551;615
1800;931;56;253;91;98;14;1429;1443
1801;205;7;41;3;2;46;258;304
1802;45;7;99;4;25;43;180;223
1803;848;154;323;201;61;78;1587;1665
1804;420;15;186;151;38;15;810;825
1805;713;0;264;120;80;34;1177;1211
1806;8;8;22;24;11;9;73;82
1807;50;15;110;39;15;15;229;244
1808;0;7;5;26;2;17;40;57
1809;816;42;450;55;56;154;1419;1573
1810;691;7;61;10;0;46;769;815
1811;879;143;797;106;143;143;2068;2211
1812;3;2;12;0;1;9;18;27
1813;676;161;426;210;44;58;1517;1575
1814;618;44;215;0;17;36;894;930
1815;24;0;8;0;1;4;33;37
1816;1;1;4;11;9;10;26;36
1817;273;86;208;177;14;43;758;801
1818;728;17;133;11;8;124;897;1021
1819;5;2;8;2;2;9;19;28
1820;129;0;21;0;1;7;151;158
1821;667;50;850;21;83;83;1671;1754
1822;62;1;44;6;5;22;118;140
1823;493;26;206;116;80;80;921;1001
1824;750;8;125;11;8;26;902;928
1825;750;71;174;13;10;20;1018;1038
1826;450;26;535;73;98;26;1182;1208
1827;50;4;44;10;10;43;118;161
1828;23;0;9;0;0;12;32;44
1829;37;5;56;12;8;5;118;123
1830;280;7;81;20;0;27;388;415
1831;483;72;567;94;12;108;1228;1336
1832;28;34;62;11;14;44;149;193
1833;308;0;73;0;0;23;381;404
1834;22;2;12;0;2;5;38;43
1835;21;5;3;10;1;7;40;47
1836;202;47;197;55;42;149;543;692
1837;4;0;4;0;0;5;8;13
1838;1;3;2;20;30;47;56;103
1839;340;108;185;130;38;100;801;901
1840;261;23;73;4;23;50;384;434
1841;1;3;3;8;1;13;16;29
1842;122;21;43;25;10;15;221;236
1843;62;1;20;4;0;7;87;94
1844;182;4;33;0;2;42;221;263
1845;367;4;51;6;4;95;432;527
1846;1017;33;417;108;100;16;1675;1691
1847;7;2;9;2;0;2;20;22
1848;99;2;11;4;0;16;116;132
1849;48;58;68;16;66;43;256;299
1850;240;67;500;199;0;163;1006;1169
1851;433;89;650;16;102;102;1290;1392
1852;240;67;500;199;0;163;1006;1169
1853;162;28;818;0;28;56;1036;1092
1854;35;0;13;2;0;2;50;52
1855;16;4;12;2;4;321;38;359
1856;83;2;101;64;26;117;276;393
1857;6;6;15;10;5;2;42;44
1858;24;4;22;0;2;9;52;61
1859;4;9;12;11;2;8;38;46
1860;526;35;214;69;53;35;897;932
1861;675;144;133;94;192;241;1238;1479
1862;575;80;428;208;93;80;1384;1464
1863;35;4;17;7;6;64;69;133
1864;322;3;50;4;3;42;382;424
1865;671;47;655;145;111;15;1629;1644
1866;176;72;98;136;21;229;503;732
1867;4;2;5;2;0;0;13;13
1868;1245;33;332;21;33;16;1664;1680
1869;23;4;10;0;2;15;39;54
1870;6;2;9;2;1;5;20;25
1871;38;15;54;3;8;29;118;147
1872;270;31;88;11;48;22;448;470
1873;141;11;114;15;14;5;295;300
1874;301;11;61;4;7;11;384;395
1875;2;8;11;3;8;21;32;53
1876;154;0;50;6;11;37;221;258
1877;16;11;15;2;0;12;44;56
1878;54;0;10;0;0;2;64;66
1879;19;1;20;16;14;28;70;98
1880;21;12;12;0;3;3;48;51
1881;228;19;130;4;11;51;392;443
1882;254;10;44;30;10;227;348;575
1883;315;0;31;4;0;91;350;441
1884;448;21;125;52;101;62;747;809
1885;51;0;16;0;0;4;67;71
1886;580;6;58;8;0;27;652;679
1887;104;12;48;4;12;5;180;185
1888;71;0;13;3;1;0;88;88
1889;934;24;230;16;24;36;1228;1264
1890;504;23;117;179;28;44;851;895
1891;22;2;18;0;2;12;44;56
1892;121;24;124;24;15;42;308;350
1893;182;2;49;17;13;20;263;283
1894;457;5;106;15;17;53;600;653
1895;297;0;38;13;0;152;348;500
1896;35;1;16;0;1;1;53;54
1897;70;3;37;4;2;64;116;180
1898;516;0;21;0;0;5;537;542
1899;23;1;7;0;4;24;35;59
1900;229;7;137;4;0;91;377;468
1901;16;3;15;2;1;11;37;48
1902;39;1;16;2;0;3;58;61
1903;3;2;8;20;0;17;33;50
1904;561;14;113;10;14;35;712;747
1905;28;6;27;12;17;39;90;129
1906;2;8;10;12;14;23;46;69
1907;492;5;32;13;5;21;547;568
1908;24;3;26;7;1;23;61;84
1909;496;32;849;229;48;128;1654;1782
1910;471;102;125;212;61;245;971;1216
1911;28;0;9;3;0;0;40;40
1912;376;4;94;12;9;24;495;519
1913;5;11;16;21;8;45;61;106
1914;853;10;143;13;10;20;1029;1049
1915;226;22;133;41;31;31;453;484
1916;587;51;932;180;34;86;1784;1870
1917;5;1;6;3;4;3;19;22
1918;266;21;300;65;8;44;660;704
1919;9;9;11;13;10;16;52;68
1920;9;1;2;3;2;0;17;17
1921;530;142;217;62;9;56;960;1016
1922;26;1;10;2;0;1;39;40
1923;654;7;92;0;15;30;768;798
1924;26;3;23;4;7;3;63;66
1925;2;0;9;3;6;2;20;22
1926;94;1;33;13;12;12;153;165
1927;519;50;167;130;0;41;866;907
1928;918;10;129;13;0;129;1070;1199
1929;16;17;19;20;21;22;93;115
1930;709;43;182;42;118;247;1094;1341
1931;184;178;178;103;39;33;682;715
1932;366;124;156;71;78;54;795;849
1933;908;43;735;40;194;21;1920;1941
1934;908;48;217;32;12;24;1217;1241
1935;158;0;23;0;0;18;181;199
1936;544;35;133;23;151;107;886;993
1937;912;72;170;47;36;97;1237;1334
1938;627;120;414;121;80;93;1362;1455
1939;428;30;214;80;30;61;782;843
1940;77;8;44;10;10;25;149;174
1941;84;3;61;2;1;21;151;172
1942;10;3;3;0;0;0;16;16
1943;40;15;15;17;6;7;93;100
1944;25;0;8;0;1;4;34;38
1945;611;76;749;59;45;26;1540;1566
1946;9;1;5;2;1;4;18;22
1947;556;54;845;202;133;63;1790;1853
1948;833;80;363;52;26;174;1354;1528
1949;229;7;140;10;3;11;389;400
1950;958;159;447;20;0;31;1584;1615
1951;240;132;445;250;192;108;1259;1367
1952;224;155;155;192;93;54;819;873
1953;239;3;141;0;7;23;390;413
1954;228;122;122;208;129;30;809;839
1955;11;2;7;4;2;2;26;28
1956;269;129;495;182;43;29;1118;1147
1957;572;19;286;50;38;248;965;1213
1958;180;60;241;13;54;54;548;602
1959;576;7;115;19;7;7;724;731
1960;178;4;26;8;4;44;220;264
1961;12;0;13;4;2;4;31;35
1962;41;0;10;0;0;3;51;54
1963;14;0;4;0;0;8;18;26
1964;56;7;48;10;2;18;123;141
1965;89;15;89;34;42;5;269;274
1966;23;2;11;3;1;4;40;44
1967;3;3;3;15;4;15;28;43
1968;0;1;4;15;1;5;21;26
1969;1013;30;399;60;46;153;1548;1701
1970;293;8;124;11;4;106;440;546
1971;3;3;24;34;7;31;71;102
1972;33;0;5;0;0;15;38;53
1973;90;38;67;33;36;67;264;331
1974;224;12;48;4;12;12;300;312
1975;8;26;46;38;9;49;127;176
1976;302;29;131;32;0;27;494;521
1977;519;71;860;93;27;53;1570;1623
1978;19;8;29;0;12;26;68;94
1979;1311;0;359;46;89;17;1805;1822
1980;25;0;11;3;0;15;39;54
1981;1486;55;278;49;0;185;1868;2053
1982;196;25;607;67;17;49;912;961
1983;890;63;292;0;25;12;1270;1282
1984;1092;37;592;145;37;55;1903;1958
1985;23;2;17;2;1;0;45;45
1986;200;19;111;50;15;19;395;414
1987;626;0;70;0;7;28;703;731
1988;4;0;2;0;0;2;6;8
1989;43;4;12;8;0;27;67;94
1990;279;83;88;32;14;34;496;530
1991;85;15;27;13;13;21;153;174
1992;1115;12;128;33;12;76;1300;1376
1993;125;17;52;3;19;30;216;246
1994;960;0;883;50;38;0;1931;1931
1995;570;73;614;133;102;73;1492;1565
1996;1276;24;746;94;29;48;2169;2217
1997;4;8;11;19;12;26;54;80
1998;132;0;16;0;0;4;148;152
1999;724;17;143;0;8;196;892;1088
2000;594;51;631;72;55;32;1403;1435
2001;12;4;7;1;3;5;27;32
2002;293;6;23;13;6;92;341;433
2003;1074;37;518;193;92;129;1914;2043
2004;12;0;13;2;0;10;27;37
2005;464;5;64;7;0;70;540;610
2006;29;0;8;2;0;6;39;45
2007;741;68;689;224;68;103;1790;1893
2008;7;2;8;3;2;3;22;25
2009;4;24;11;16;1;25;56;81
2010;6;6;29;12;15;8;68;76
2011;18;0;2;0;0;2;20;22
2012;13;3;8;7;4;16;35;51
2013;4;2;5;0;0;5;11;16
2014;835;73;380;114;73;43;1475;1518
2015;29;1;11;0;0;0;41;41
2016;171;3;129;26;24;62;353;415
2017;1090;12;96;16;12;60;1226;1286
2018;3;2;11;2;2;10;20;30
2019;24;0;27;8;30;10;89;99
2020;737;21;106;55;63;210;982;1192
2021;254;6;71;4;0;27;335;362
